111111111111111
1000000U0000001
100000000000001
100000000000001
111111111111111
