111111111111111111111
1P000000000000C0N0001
100111111111111110001
100C0011111111100C001
1000111111100N00C0001
100111C01111110000N01
100000011111110001101
10N1100000000000000E1
111111111111111111111
