111111111111111111111111
1P000000000000C000000001
100111111111111111111101
100C00000000000000000001
1000000000000000000000E1
111111111111111111111111

