111111111111
1P000C00N001
101111111101
1000C00000E1
111111111111
