11111111111111
1P0000000000P1
1000C000000N01
100000000000E1
11111111111111
