111111111111111111111111111111111111
1P000000000000C000000000000N00000001
100011111111111111111111111111110001
100000000000000000000C00000000000001
101111111111111111111111111111110101
100000000000000000000000000000000001
100011111111000100000000000000000001
100000000000000000N000000C0000000001
10000000000011111111000000000C000001
1111111000000N0000000111100000C00N01
100C000000011110000N0000001111111111
111111000000000111111111000000000111
1000000000001111C0000000001111100001
10000C0000000000C00011000000000000E1
111111111111111111111111111111111111
