111111111111111111111111111111111111
1P000000000000C000000000000000000001
100011111111111111111111111111110001
100000000000000000000C00000000000001
101111111111111111111111111111110101
100000000000000000000000000000000001
100011111111000100000000000000000001
1000000000000000000000000C00000000E1
111111111111111111111111111111111111
