11111011111111
1P000000000001
1000C000000N01
100000000000E1
11111111111111
